00 00 00 00 00 00 00 00 00 00 00 00 00 00 00 00 00 00 00 00
00 00 00 00 00 00 00 00 00 00 00 00 00 00 00 00 00 00 00 00
00 00 00 00 00 00 00 00 00 00 00 00 00 00 00 00 00 00 00 00
00 00 00 00 00 00 10 00 00 00 00 00 00 00 00 00 00 00 00 00
00 00 00 00 03 00 00 00 00 00 00 00 00 00 00 00 00 00 00 00
00 00 00 00 00 00 03 00 00 00 00 00 02 00 00 00 00 00 00 00
00 00 00 00 00 00 00 00 01 05 08 08 08 06 00 03 00 03 00 00
00 00 00 00 00 00 00 00 00 00 00 00 00 00 00 00 00 00 00 01
00 00 00 00 00 00 00 00 00 00 00 00 00 00 00 00 00 00 00 01
00 00 00 02 00 00 00 00 00 00 00 00 00 00 00 00 00 00 00 01
00 00 02 02 00 00 00 00 00 00 00 00 00 00 00 00 00 00 00 01
08 08 08 08 08 06 01 01 02 01 00 00 02 01 05 08 08 08 08 08