00 00 00 00 00 00 00 00 00 00 00 00 00 00 00 00 00 00 00 00
00 00 00 00 00 00 00 00 00 00 00 00 00 00 06 00 00 00 00 00
00 00 00 00 00 00 00 00 00 00 00 00 00 00 00 00 00 00 00 00
00 00 00 00 00 00 00 00 00 00 00 00 00 00 00 00 00 00 00 00
00 00 04 00 00 00 00 00 00 00 00 00 00 00 00 00 00 00 00 00
00 00 00 00 00 00 00 00 00 02 00 00 00 00 00 00 00 00 00 06
00 00 00 00 00 00 00 00 00 00 06 00 00 00 00 00 00 00 00 00
00 00 00 00 00 00 00 00 06 00 00 00 00 00 04 00 00 00 00 00
00 00 00 00 10 00 00 00 00 00 00 00 00 00 00 00 00 00 00 00
00 05 00 02 00 00 03 00 00 00 07 00 00 00 02 00 00 00 00 00
00 00 02 00 00 00 00 00 00 00 00 00 00 00 00 00 00 00 00 00
02 02 02 02 02 02 02 02 02 02 02 00 06 00 00 00 00 00 00 00