00 00 00 00 00 01 02 04 03 00 00 00 00 00 00 00 00 00 00 00
00 00 00 00 00 00 00 00 00 00 00 00 00 00 00 00 00 00 00 00
00 00 00 00 00 00 00 00 00 00 00 00 00 00 00 00 00 00 00 00
00 00 00 00 00 00 00 01 00 00 00 00 00 00 00 00 00 00 00 00
00 00 00 00 00 00 00 01 00 00 00 00 00 00 00 00 00 00 00 00
00 00 00 00 00 00 00 01 00 00 00 00 00 00 00 00 00 00 00 00
00 00 00 00 00 00 00 01 00 00 00 00 00 00 00 00 00 00 00 00
00 00 00 00 00 00 00 00 00 00 00 00 00 00 00 03 00 00 00 00
00 00 00 00 00 05 03 01 01 01 03 01 01 01 01 04 00 00 00 00
02 01 01 01 01 01 04 00 00 00 04 00 00 00 00 00 00 00 00 00
02 02 00 00 00 00 04 00 00 00 04 02 00 00 00 00 00 00 00 00
02 02 02 02 00 00 04 00 00 00 04 02 02 02 02 00 00 00 00 00